 _FTT _FTT _FTT _FTT _FTT _FTT _FTT _FTT _FTT _FTT 
 _FTT _FVV _FVV _FVV _FVV _FVV _FVV _FVV _FVV _FTT 
 _FTT _FVV _FVV _FVV _FVV _FVV _FVV _FVV _FVV _FTT 
 _FTT _FVV _FVV _FVV _FVV _FVV _FVV _FVV _FVV _FTT 
 _FTT _FVV _FVV _FVV _FZT _FVV _FVV _FVV _FVV _FTT 
 _FTT _FVV _FVV _FVV _FVV _FVV _FVV _FVV _FVV _FTT 
 _FTT _FVV _FVV _FVV _FVV _FVV _FVV _FVV _FVV _FTT 
 _FTT _FVV _FVV _FVV _FVV _FVV _FVV _FVV _FVV _FTT 
 _FTT _FVV _FVV _FVV _FVV _FVV _FVV _FVV CFVV _FTT 
 _FTT _FTT _FTT _FTT _FTT _FTT _FTT _FTT _FTT _FTT 